STATE/UT,CRIME HEAD,Cases Pending Investigation from Previous Year,Cases reported during the year,No. of cases withdrawn by the Govt. during investigation,Cases not investigated or in which investigation was refused,Cases declared false on account of mistake of fact or of law,Cases in which chargesheets were laid,Cases in which charge-sheets were not laid but final report submitted during the year,Total cases (Chargesheeted + Final Report submitted),Cases pending investigation at the end of the year,Cases pending trial from the previous year,Cases sent for trial during the year,No. of cases withdrawn by the Govt.,Total cases for trial during the year,Cases compounded or withdrawn,Cases in which trials were completed,Cases convicted,Cases acquitted or discharged,Cases pending trial at the end of the year
ANDHRA PRADESH,RAPE (SECTION 376 IPC),854,1341,0,0,72,1276,16,1292,831,2782,1276,0,4058,13,961,108,853,3084
ARUNACHAL PRADESH,RAPE (SECTION 376 IPC),33,46,0,0,0,24,3,27,52,524,24,0,548,1,30,3,27,517
ASSAM,RAPE (SECTION 376 IPC),2793,1716,0,47,22,1110,280,1390,3050,4993,1110,0,6103,0,506,97,409,5597
BIHAR,RAPE (SECTION 376 IPC),936,927,0,0,161,902,93,995,707,3253,902,0,4155,0,609,119,490,3546
CHHATTISGARH,RAPE (SECTION 376 IPC),140,1034,0,4,6,988,9,997,167,3764,988,0,4752,128,977,223,754,3647
GOA,RAPE (SECTION 376 IPC),30,55,0,0,0,26,4,30,55,97,26,0,123,1,12,1,11,110
GUJARAT,RAPE (SECTION 376 IPC),77,473,0,2,8,438,12,450,90,2935,438,0,3373,2,202,31,171,3169
HARYANA,RAPE (SECTION 376 IPC),182,668,0,0,126,635,10,645,79,977,635,0,1612,0,526,133,393,1086
HIMACHAL PRADESH,RAPE (SECTION 376 IPC),47,183,0,0,24,149,2,151,55,486,149,0,635,1,107,29,78,527
JAMMU & KASHMIR,RAPE (SECTION 376 IPC),73,303,0,0,53,257,3,260,63,1052,257,0,1309,4,253,19,234,1052
JHARKHAND,RAPE (SECTION 376 IPC),592,812,0,0,34,602,86,688,682,1795,602,0,2397,18,562,161,401,1817
KARNATAKA,RAPE (SECTION 376 IPC),252,621,0,2,22,587,14,601,248,1489,587,0,2076,0,428,65,363,1648
KERALA,RAPE (SECTION 376 IPC),804,1019,0,1,35,961,29,990,797,4320,961,0,5281,0,249,57,192,5032
MADHYA PRADESH,RAPE (SECTION 376 IPC),302,3425,0,0,44,3483,45,3528,155,7790,3483,0,11273,47,2801,547,2254,8425
MAHARASHTRA,RAPE (SECTION 376 IPC),670,1839,0,2,34,1616,32,1648,825,12798,1616,0,14414,8,1018,164,854,13388
MANIPUR,RAPE (SECTION 376 IPC),183,63,0,0,0,9,11,20,226,67,9,0,76,1,1,0,1,74
MEGHALAYA,RAPE (SECTION 376 IPC),333,164,0,0,0,93,10,103,394,544,93,0,637,1,15,7,8,621
MIZORAM,RAPE (SECTION 376 IPC),22,103,0,0,0,95,3,98,27,108,95,0,203,0,74,61,13,129
NAGALAND,RAPE (SECTION 376 IPC),2,21,0,0,0,15,4,19,4,30,15,0,45,0,11,8,3,34
ODISHA,RAPE (SECTION 376 IPC),776,1458,0,0,53,1336,7,1343,838,4537,1336,0,5873,0,724,154,570,5149
PUNJAB,RAPE (SECTION 376 IPC),166,680,0,0,61,512,28,540,245,453,512,0,965,2,456,151,305,507
RAJASTHAN,RAPE (SECTION 376 IPC),171,2049,0,1,745,1225,3,1228,246,3127,1225,0,4352,28,766,230,536,3558
SIKKIM,RAPE (SECTION 376 IPC),7,34,0,0,0,24,6,30,11,78,24,0,102,0,2,1,1,100
TAMIL NADU,RAPE (SECTION 376 IPC),731,737,0,0,65,558,13,571,832,1617,558,0,2175,0,299,60,239,1876
TRIPURA,RAPE (SECTION 376 IPC),68,229,0,0,1,206,3,209,87,687,206,0,893,0,109,16,93,784
UTTAR PRADESH,RAPE (SECTION 376 IPC),139,1963,0,0,247,1513,145,1658,197,4278,1513,0,5791,36,1230,619,611,4525
UTTARAKHAND,RAPE (SECTION 376 IPC),19,148,0,0,10,128,13,141,16,242,128,0,370,0,119,75,44,251
WEST BENGAL,RAPE (SECTION 376 IPC),2635,2046,0,0,1,2165,85,2250,2430,13032,2165,0,15197,0,1023,112,911,14174
TOTAL (STATES),RAPE (SECTION 376 IPC),13037,24157,0,59,1824,20933,969,21902,13409,77855,20933,0,98788,291,14070,3251,10819,84427
A & N ISLANDS,RAPE (SECTION 376 IPC),7,12,0,0,0,7,0,7,12,87,7,0,94,0,8,3,5,86
CHANDIGARH,RAPE (SECTION 376 IPC),18,27,0,0,0,34,1,35,10,46,34,0,80,0,27,9,18,53
D & N HAVELI,RAPE (SECTION 376 IPC),5,3,0,0,0,6,1,7,1,12,6,0,18,0,5,1,4,13
DAMAN & DIU,RAPE (SECTION 376 IPC),1,5,0,0,0,4,0,4,2,2,4,0,6,1,2,1,1,3
DELHI,RAPE (SECTION 376 IPC),147,706,0,1,9,568,20,588,255,1439,568,0,2007,0,603,297,306,1404
LAKSHADWEEP,RAPE (SECTION 376 IPC),0,0,0,0,0,0,0,0,0,0,0,0,0,0,0,0,0,0
PUDUCHERRY,RAPE (SECTION 376 IPC),6,13,0,0,0,13,0,13,6,35,13,0,48,0,2,1,1,46
TOTAL (UTs),RAPE (SECTION 376 IPC),184,766,0,1,9,632,22,654,286,1621,632,0,2253,1,647,312,335,1605
TOTAL (ALL-INDIA),RAPE (SECTION 376 IPC),13221,24923,0,60,1833,21565,991,22556,13695,79476,21565,0,101041,292,14717,3563,11154,86032
ANDHRA PRADESH,"KIDNAPPING AND ABDUCTION (SECTION 363-369, 371-373 IPC)",576,1403,0,0,344,966,84,1050,585,2744,966,0,3710,69,891,58,833,2750
ARUNACHAL PRADESH,"KIDNAPPING AND ABDUCTION (SECTION 363-369, 371-373 IPC)",52,58,0,0,0,32,23,55,55,403,32,0,435,8,30,7,23,397
ASSAM,"KIDNAPPING AND ABDUCTION (SECTION 363-369, 371-373 IPC)",4317,3360,0,123,231,1247,1108,2355,4968,3779,1247,0,5026,0,712,50,662,4314
BIHAR,"KIDNAPPING AND ABDUCTION (SECTION 363-369, 371-373 IPC)",2007,3789,0,0,1343,2028,432,2460,1993,4832,2028,0,6860,1,754,55,699,6105
CHHATTISGARH,"KIDNAPPING AND ABDUCTION (SECTION 363-369, 371-373 IPC)",141,350,0,0,10,316,36,352,129,909,316,0,1225,0,151,42,109,1074
GOA,"KIDNAPPING AND ABDUCTION (SECTION 363-369, 371-373 IPC)",22,16,0,0,0,12,4,16,22,40,12,0,52,0,2,0,2,50
GUJARAT,"KIDNAPPING AND ABDUCTION (SECTION 363-369, 371-373 IPC)",411,1527,1,10,56,1191,276,1467,404,7839,1191,0,9030,25,435,30,405,8570
HARYANA,"KIDNAPPING AND ABDUCTION (SECTION 363-369, 371-373 IPC)",231,900,0,0,337,467,81,548,246,1088,467,0,1555,0,313,47,266,1242
HIMACHAL PRADESH,"KIDNAPPING AND ABDUCTION (SECTION 363-369, 371-373 IPC)",87,152,0,0,85,73,17,90,64,250,73,0,323,4,44,9,35,275
JAMMU & KASHMIR,"KIDNAPPING AND ABDUCTION (SECTION 363-369, 371-373 IPC)",476,1041,0,1,520,528,27,555,441,3909,528,0,4437,3,455,4,451,3979
JHARKHAND,"KIDNAPPING AND ABDUCTION (SECTION 363-369, 371-373 IPC)",393,786,0,0,62,523,155,678,439,893,523,0,1416,10,410,122,288,996
KARNATAKA,"KIDNAPPING AND ABDUCTION (SECTION 363-369, 371-373 IPC)",260,1070,0,6,234,450,88,538,552,1089,450,0,1539,11,238,14,224,1290
KERALA,"KIDNAPPING AND ABDUCTION (SECTION 363-369, 371-373 IPC)",128,214,0,0,11,197,14,211,120,888,197,0,1085,0,62,5,57,1023
MADHYA PRADESH,"KIDNAPPING AND ABDUCTION (SECTION 363-369, 371-373 IPC)",469,1127,0,0,18,1112,69,1181,397,2595,1112,5,3702,11,680,158,522,3011
MAHARASHTRA,"KIDNAPPING AND ABDUCTION (SECTION 363-369, 371-373 IPC)",843,1140,0,7,116,856,137,993,867,7001,856,0,7857,19,451,23,428,7387
MANIPUR,"KIDNAPPING AND ABDUCTION (SECTION 363-369, 371-373 IPC)",433,133,0,0,0,2,79,81,485,18,2,0,20,0,1,0,1,19
MEGHALAYA,"KIDNAPPING AND ABDUCTION (SECTION 363-369, 371-373 IPC)",135,24,0,0,0,12,9,21,138,84,12,0,96,1,4,0,4,91
MIZORAM,"KIDNAPPING AND ABDUCTION (SECTION 363-369, 371-373 IPC)",0,3,0,0,0,3,0,3,0,0,3,0,3,0,2,2,0,1
NAGALAND,"KIDNAPPING AND ABDUCTION (SECTION 363-369, 371-373 IPC)",3,10,0,0,0,3,1,4,9,2,3,0,5,0,3,2,1,2
ODISHA,"KIDNAPPING AND ABDUCTION (SECTION 363-369, 371-373 IPC)",874,1364,0,0,187,1029,37,1066,985,2976,1029,0,4005,0,441,35,406,3564
PUNJAB,"KIDNAPPING AND ABDUCTION (SECTION 363-369, 371-373 IPC)",461,689,0,0,212,253,63,316,622,941,253,0,1194,1,102,18,84,1091
RAJASTHAN,"KIDNAPPING AND ABDUCTION (SECTION 363-369, 371-373 IPC)",369,2697,0,0,1557,982,126,1108,401,4862,982,0,5844,30,631,190,441,5183
SIKKIM,"KIDNAPPING AND ABDUCTION (SECTION 363-369, 371-373 IPC)",11,10,0,0,0,6,5,11,10,22,6,0,28,0,4,2,2,24
TAMIL NADU,"KIDNAPPING AND ABDUCTION (SECTION 363-369, 371-373 IPC)",1368,1693,0,0,447,706,471,1177,1437,1492,706,0,2198,0,555,48,507,1643
TRIPURA,"KIDNAPPING AND ABDUCTION (SECTION 363-369, 371-373 IPC)",46,114,0,0,2,88,23,111,47,249,88,0,337,0,46,3,43,291
UTTAR PRADESH,"KIDNAPPING AND ABDUCTION (SECTION 363-369, 371-373 IPC)",1367,7910,0,0,647,4329,2620,6949,1681,8674,4329,0,13003,93,2221,1055,1166,10689
UTTARAKHAND,"KIDNAPPING AND ABDUCTION (SECTION 363-369, 371-373 IPC)",50,256,0,0,28,142,97,239,39,637,142,0,779,0,185,130,55,594
WEST BENGAL,"KIDNAPPING AND ABDUCTION (SECTION 363-369, 371-373 IPC)",3892,4168,0,0,79,2770,840,3610,4371,10954,2770,0,13724,19,611,22,589,13094
TOTAL (STATES),"KIDNAPPING AND ABDUCTION (SECTION 363-369, 371-373 IPC)",19422,36004,1,147,6526,20323,6922,27245,21507,69170,20323,5,89488,305,10434,2131,8303,78749
A & N ISLANDS,"KIDNAPPING AND ABDUCTION (SECTION 363-369, 371-373 IPC)",13,7,0,0,0,7,2,9,11,45,7,0,52,0,2,1,1,50
CHANDIGARH,"KIDNAPPING AND ABDUCTION (SECTION 363-369, 371-373 IPC)",36,66,0,0,10,48,7,55,37,32,48,0,80,0,13,4,9,67
D & N HAVELI,"KIDNAPPING AND ABDUCTION (SECTION 363-369, 371-373 IPC)",14,9,0,0,0,8,6,14,9,31,8,0,39,0,5,1,4,34
DAMAN & DIU,"KIDNAPPING AND ABDUCTION (SECTION 363-369, 371-373 IPC)",4,0,0,0,0,3,0,3,1,2,3,0,5,0,2,0,2,3
DELHI,"KIDNAPPING AND ABDUCTION (SECTION 363-369, 371-373 IPC)",2447,2160,42,19,745,353,785,1138,2663,1755,353,0,2108,0,464,177,287,1644
LAKSHADWEEP,"KIDNAPPING AND ABDUCTION (SECTION 363-369, 371-373 IPC)",0,0,0,0,0,0,0,0,0,0,0,0,0,0,0,0,0,0
PUDUCHERRY,"KIDNAPPING AND ABDUCTION (SECTION 363-369, 371-373 IPC)",4,16,0,0,2,12,0,12,6,43,12,0,55,0,7,3,4,48
TOTAL (UTs),"KIDNAPPING AND ABDUCTION (SECTION 363-369, 371-373 IPC)",2518,2258,42,19,757,431,800,1231,2727,1908,431,0,2339,0,493,186,307,1846
TOTAL (ALL-INDIA),"KIDNAPPING AND ABDUCTION (SECTION 363-369, 371-373 IPC)",21940,38262,43,166,7283,20754,7722,28476,24234,71078,20754,5,91827,305,10927,2317,8610,80595
ANDHRA PRADESH,DOWRY DEATH (SECTION 304-B IPC),373,504,0,0,24,532,9,541,312,1271,532,0,1803,1,495,55,440,1307
ARUNACHAL PRADESH,DOWRY DEATH (SECTION 304-B IPC),0,1,0,0,0,0,0,0,1,0,0,0,0,0,0,0,0,0
ASSAM,DOWRY DEATH (SECTION 304-B IPC),246,140,0,3,7,85,26,111,265,405,85,0,490,0,25,10,15,465
BIHAR,DOWRY DEATH (SECTION 304-B IPC),1785,1275,0,0,190,1349,122,1471,1399,4538,1349,0,5887,0,543,164,379,5344
CHHATTISGARH,DOWRY DEATH (SECTION 304-B IPC),9,81,0,0,0,81,1,82,8,429,81,0,510,10,86,40,46,414
GOA,DOWRY DEATH (SECTION 304-B IPC),3,0,0,0,0,1,1,2,1,8,1,0,9,0,0,0,0,9
GUJARAT,DOWRY DEATH (SECTION 304-B IPC),6,21,0,0,0,22,0,22,5,511,22,0,533,0,30,0,30,503
HARYANA,DOWRY DEATH (SECTION 304-B IPC),40,258,0,0,30,231,3,234,34,492,231,0,723,0,256,69,187,467
HIMACHAL PRADESH,DOWRY DEATH (SECTION 304-B IPC),1,2,0,0,1,2,0,2,0,23,2,0,25,0,3,0,3,22
JAMMU & KASHMIR,DOWRY DEATH (SECTION 304-B IPC),8,8,0,0,1,13,0,13,2,54,13,0,67,0,7,1,6,60
JHARKHAND,DOWRY DEATH (SECTION 304-B IPC),290,302,0,0,7,252,32,284,301,494,252,0,746,3,216,87,129,527
KARNATAKA,DOWRY DEATH (SECTION 304-B IPC),79,218,0,2,8,216,1,217,70,725,216,0,941,3,170,33,137,768
KERALA,DOWRY DEATH (SECTION 304-B IPC),15,32,0,0,0,21,1,22,25,174,21,0,195,1,12,2,10,182
MADHYA PRADESH,DOWRY DEATH (SECTION 304-B IPC),90,743,0,0,0,762,2,764,69,2171,762,0,2933,24,572,188,384,2337
MAHARASHTRA,DOWRY DEATH (SECTION 304-B IPC),94,329,0,0,4,297,8,305,114,3660,297,0,3957,4,189,32,157,3764
MANIPUR,DOWRY DEATH (SECTION 304-B IPC),2,0,0,0,0,0,0,0,2,0,0,0,0,0,0,0,0,0
MEGHALAYA,DOWRY DEATH (SECTION 304-B IPC),4,1,0,0,0,0,0,0,5,6,0,0,6,0,0,0,0,6
MIZORAM,DOWRY DEATH (SECTION 304-B IPC),0,0,0,0,0,0,0,0,0,0,0,0,0,0,0,0,0,0
NAGALAND,DOWRY DEATH (SECTION 304-B IPC),0,0,0,0,0,0,0,0,0,0,0,0,0,0,0,0,0,0
ODISHA,DOWRY DEATH (SECTION 304-B IPC),432,525,0,1,14,494,4,498,444,1573,494,0,2067,0,290,24,266,1777
PUNJAB,DOWRY DEATH (SECTION 304-B IPC),88,118,0,0,8,95,5,100,98,305,95,0,400,0,99,46,53,301
RAJASTHAN,DOWRY DEATH (SECTION 304-B IPC),64,478,0,0,100,357,2,359,83,1760,357,0,2117,19,235,95,140,1863
SIKKIM,DOWRY DEATH (SECTION 304-B IPC),1,1,0,0,0,2,0,2,0,0,2,0,2,0,0,0,0,2
TAMIL NADU,DOWRY DEATH (SECTION 304-B IPC),148,110,0,0,0,124,3,127,131,549,124,0,673,0,108,20,88,565
TRIPURA,DOWRY DEATH (SECTION 304-B IPC),9,37,0,0,0,27,0,27,19,113,27,0,140,0,22,5,17,118
UTTAR PRADESH,DOWRY DEATH (SECTION 304-B IPC),327,2244,0,0,145,1785,241,2026,400,6952,1785,0,8737,37,1265,619,646,7435
UTTARAKHAND,DOWRY DEATH (SECTION 304-B IPC),15,71,0,0,3,64,8,72,11,229,64,0,293,0,121,90,31,172
WEST BENGAL,DOWRY DEATH (SECTION 304-B IPC),536,593,0,1,1,575,14,589,538,2324,575,0,2899,0,334,41,293,2565
TOTAL (STATES),DOWRY DEATH (SECTION 304-B IPC),4665,8092,0,7,543,7387,483,7870,4337,28766,7387,0,36153,102,5078,1621,3457,30973
A & N ISLANDS,DOWRY DEATH (SECTION 304-B IPC),0,2,0,0,0,1,0,1,1,5,1,0,6,0,0,0,0,6
CHANDIGARH,DOWRY DEATH (SECTION 304-B IPC),3,5,0,0,0,7,0,7,1,3,7,0,10,0,4,1,3,6
D & N HAVELI,DOWRY DEATH (SECTION 304-B IPC),0,0,0,0,0,0,0,0,0,2,0,0,2,0,0,0,0,2
DAMAN & DIU,DOWRY DEATH (SECTION 304-B IPC),0,0,0,0,0,0,0,0,0,0,0,0,0,0,0,0,0,0
DELHI,DOWRY DEATH (SECTION 304-B IPC),84,134,0,0,2,141,2,143,73,879,141,0,1020,0,133,62,71,887
LAKSHADWEEP,DOWRY DEATH (SECTION 304-B IPC),0,0,0,0,0,0,0,0,0,0,0,0,0,0,0,0,0,0
PUDUCHERRY,DOWRY DEATH (SECTION 304-B IPC),2,0,0,0,0,1,0,1,1,14,1,0,15,0,1,0,1,14
TOTAL (UTs),DOWRY DEATH (SECTION 304-B IPC),89,141,0,0,2,150,2,152,76,903,150,0,1053,0,138,63,75,915
TOTAL (ALL-INDIA),DOWRY DEATH (SECTION 304-B IPC),4754,8233,0,7,545,7537,485,8022,4413,29669,7537,0,37206,102,5216,1684,3532,31888
ANDHRA PRADESH,ASSAULT ON WOMEN WITH INTENT TO OUTRAGE HER MODESTY (SECTION 354 IPC),1141,4816,0,0,691,3372,106,3478,1788,6908,3372,0,10280,482,2727,250,2477,7071
ARUNACHAL PRADESH,ASSAULT ON WOMEN WITH INTENT TO OUTRAGE HER MODESTY (SECTION 354 IPC),33,67,0,0,0,51,9,60,40,422,51,0,473,2,31,12,19,440
ASSAM,ASSAULT ON WOMEN WITH INTENT TO OUTRAGE HER MODESTY (SECTION 354 IPC),1129,1840,0,25,86,1063,491,1554,1304,2088,1063,0,3151,7,755,67,688,2389
BIHAR,ASSAULT ON WOMEN WITH INTENT TO OUTRAGE HER MODESTY (SECTION 354 IPC),328,118,0,0,17,299,45,344,85,2453,299,0,2752,46,393,49,344,2313
CHHATTISGARH,ASSAULT ON WOMEN WITH INTENT TO OUTRAGE HER MODESTY (SECTION 354 IPC),93,1601,0,2,3,1587,13,1600,89,7924,1587,0,9511,238,1296,456,840,7977
GOA,ASSAULT ON WOMEN WITH INTENT TO OUTRAGE HER MODESTY (SECTION 354 IPC),20,49,0,1,0,21,3,24,44,98,21,0,119,0,18,1,17,101
GUJARAT,ASSAULT ON WOMEN WITH INTENT TO OUTRAGE HER MODESTY (SECTION 354 IPC),82,745,0,0,7,714,10,724,96,7300,714,0,8014,30,493,8,485,7491
HARYANA,ASSAULT ON WOMEN WITH INTENT TO OUTRAGE HER MODESTY (SECTION 354 IPC),65,525,0,0,76,476,10,486,28,1584,476,0,2060,0,506,118,388,1554
HIMACHAL PRADESH,ASSAULT ON WOMEN WITH INTENT TO OUTRAGE HER MODESTY (SECTION 354 IPC),63,250,0,0,15,250,7,257,41,1491,250,1,1740,26,197,27,170,1517
JAMMU & KASHMIR,ASSAULT ON WOMEN WITH INTENT TO OUTRAGE HER MODESTY (SECTION 354 IPC),165,1322,0,0,69,1233,6,1239,179,5043,1233,0,6276,248,1072,95,977,4956
JHARKHAND,ASSAULT ON WOMEN WITH INTENT TO OUTRAGE HER MODESTY (SECTION 354 IPC),156,284,0,0,2,242,32,274,164,792,242,0,1034,14,254,114,140,766
KARNATAKA,ASSAULT ON WOMEN WITH INTENT TO OUTRAGE HER MODESTY (SECTION 354 IPC),656,2978,0,3,152,2489,66,2555,924,6055,2489,13,8531,172,1836,71,1765,6523
KERALA,ASSAULT ON WOMEN WITH INTENT TO OUTRAGE HER MODESTY (SECTION 354 IPC),717,3735,0,0,224,3473,63,3536,692,12327,3473,0,15800,126,1497,186,1311,14177
MADHYA PRADESH,ASSAULT ON WOMEN WITH INTENT TO OUTRAGE HER MODESTY (SECTION 354 IPC),71,6655,0,0,11,6466,31,6497,218,22393,6466,5,28854,1975,3612,1413,2199,23267
MAHARASHTRA,ASSAULT ON WOMEN WITH INTENT TO OUTRAGE HER MODESTY (SECTION 354 IPC),1463,3935,0,6,62,3625,92,3717,1613,27787,3625,0,31412,629,2390,213,2177,28393
MANIPUR,ASSAULT ON WOMEN WITH INTENT TO OUTRAGE HER MODESTY (SECTION 354 IPC),219,49,0,0,0,7,37,44,224,9,7,0,16,0,0,0,0,16
MEGHALAYA,ASSAULT ON WOMEN WITH INTENT TO OUTRAGE HER MODESTY (SECTION 354 IPC),127,43,0,0,0,32,9,41,129,219,32,0,251,0,7,2,5,244
MIZORAM,ASSAULT ON WOMEN WITH INTENT TO OUTRAGE HER MODESTY (SECTION 354 IPC),15,85,0,0,0,81,1,82,18,70,81,0,151,0,67,45,22,84
NAGALAND,ASSAULT ON WOMEN WITH INTENT TO OUTRAGE HER MODESTY (SECTION 354 IPC),7,16,0,0,0,19,1,20,3,8,19,0,27,0,10,10,0,17
ODISHA,ASSAULT ON WOMEN WITH INTENT TO OUTRAGE HER MODESTY (SECTION 354 IPC),962,4187,0,0,211,3810,83,3893,1045,17461,3810,0,21271,0,1849,203,1646,19422
PUNJAB,ASSAULT ON WOMEN WITH INTENT TO OUTRAGE HER MODESTY (SECTION 354 IPC),232,340,0,0,30,182,40,222,320,651,182,0,833,0,172,46,126,661
RAJASTHAN,ASSAULT ON WOMEN WITH INTENT TO OUTRAGE HER MODESTY (SECTION 354 IPC),33,2352,0,0,641,1700,11,1711,33,9397,1700,0,11097,465,1402,696,706,9230
SIKKIM,ASSAULT ON WOMEN WITH INTENT TO OUTRAGE HER MODESTY (SECTION 354 IPC),10,19,0,0,0,15,6,21,8,25,15,0,40,0,7,1,6,33
TAMIL NADU,ASSAULT ON WOMEN WITH INTENT TO OUTRAGE HER MODESTY (SECTION 354 IPC),679,1494,0,0,198,1108,54,1162,813,3323,1108,0,4431,0,778,241,537,3653
TRIPURA,ASSAULT ON WOMEN WITH INTENT TO OUTRAGE HER MODESTY (SECTION 354 IPC),14,314,0,0,1,291,13,304,23,1071,291,0,1362,0,239,41,198,1123
UTTAR PRADESH,ASSAULT ON WOMEN WITH INTENT TO OUTRAGE HER MODESTY (SECTION 354 IPC),131,3247,0,0,104,2886,179,3065,209,7486,2886,0,10372,88,1777,1137,640,8507
UTTARAKHAND,ASSAULT ON WOMEN WITH INTENT TO OUTRAGE HER MODESTY (SECTION 354 IPC),4,139,0,0,3,129,4,133,7,444,129,0,573,30,188,138,50,355
WEST BENGAL,ASSAULT ON WOMEN WITH INTENT TO OUTRAGE HER MODESTY (SECTION 354 IPC),2751,3345,0,0,8,2897,187,3084,3004,13092,2897,0,15989,28,941,110,831,15020
TOTAL (STATES),ASSAULT ON WOMEN WITH INTENT TO OUTRAGE HER MODESTY (SECTION 354 IPC),11366,44550,0,37,2611,38518,1609,40127,13141,157921,38518,19,196420,4606,24514,5750,18764,167300
A & N ISLANDS,ASSAULT ON WOMEN WITH INTENT TO OUTRAGE HER MODESTY (SECTION 354 IPC),9,17,0,0,0,14,1,15,11,206,14,0,220,0,9,1,8,211
CHANDIGARH,ASSAULT ON WOMEN WITH INTENT TO OUTRAGE HER MODESTY (SECTION 354 IPC),7,45,0,0,1,30,1,31,20,74,30,0,104,0,19,1,18,85
D & N HAVELI,ASSAULT ON WOMEN WITH INTENT TO OUTRAGE HER MODESTY (SECTION 354 IPC),3,2,0,0,0,2,1,3,2,25,2,0,27,0,5,1,4,22
DAMAN & DIU,ASSAULT ON WOMEN WITH INTENT TO OUTRAGE HER MODESTY (SECTION 354 IPC),0,0,0,0,0,0,0,0,0,3,0,0,3,2,1,0,1,0
DELHI,ASSAULT ON WOMEN WITH INTENT TO OUTRAGE HER MODESTY (SECTION 354 IPC),351,727,0,1,5,671,30,701,371,3798,671,0,4469,0,754,327,427,3715
LAKSHADWEEP,ASSAULT ON WOMEN WITH INTENT TO OUTRAGE HER MODESTY (SECTION 354 IPC),0,1,0,0,0,0,0,0,1,0,0,0,0,0,0,0,0,0
PUDUCHERRY,ASSAULT ON WOMEN WITH INTENT TO OUTRAGE HER MODESTY (SECTION 354 IPC),9,9,0,1,1,8,1,9,7,250,8,0,258,0,17,2,15,241
TOTAL (UTs),ASSAULT ON WOMEN WITH INTENT TO OUTRAGE HER MODESTY (SECTION 354 IPC),379,801,0,2,7,725,34,759,412,4356,725,0,5081,2,805,332,473,4274
TOTAL (ALL-INDIA),ASSAULT ON WOMEN WITH INTENT TO OUTRAGE HER MODESTY (SECTION 354 IPC),11745,45351,0,39,2618,39243,1643,40886,13553,162277,39243,19,201501,4608,25319,6082,19237,171574
ANDHRA PRADESH,INSULT TO MODESTY OF WOMEN (SECTION 509 IPC),550,3714,0,0,228,3104,100,3204,832,4142,3104,0,7246,739,2175,693,1482,4332
ARUNACHAL PRADESH,INSULT TO MODESTY OF WOMEN (SECTION 509 IPC),0,2,0,0,0,0,0,0,2,12,0,0,12,0,0,0,0,12
ASSAM,INSULT TO MODESTY OF WOMEN (SECTION 509 IPC),8,5,0,0,0,1,0,1,12,10,1,0,11,0,1,0,1,10
BIHAR,INSULT TO MODESTY OF WOMEN (SECTION 509 IPC),2,37,0,0,1,33,3,36,2,55,33,0,88,5,22,0,22,61
CHHATTISGARH,INSULT TO MODESTY OF WOMEN (SECTION 509 IPC),11,162,0,0,1,156,3,159,13,601,156,0,757,81,83,28,55,593
GOA,INSULT TO MODESTY OF WOMEN (SECTION 509 IPC),11,16,0,0,0,6,3,9,18,31,6,0,37,1,4,1,3,32
GUJARAT,INSULT TO MODESTY OF WOMEN (SECTION 509 IPC),10,93,0,0,0,92,2,94,9,934,92,0,1026,2,80,16,64,944
HARYANA,INSULT TO MODESTY OF WOMEN (SECTION 509 IPC),46,434,0,0,16,417,16,433,31,899,417,0,1316,0,456,274,182,860
HIMACHAL PRADESH,INSULT TO MODESTY OF WOMEN (SECTION 509 IPC),20,68,0,0,6,52,6,58,24,200,52,0,252,7,12,1,11,233
JAMMU & KASHMIR,INSULT TO MODESTY OF WOMEN (SECTION 509 IPC),63,347,0,0,13,330,1,331,66,1382,330,0,1712,5,305,98,207,1402
JHARKHAND,INSULT TO MODESTY OF WOMEN (SECTION 509 IPC),48,10,0,0,0,20,1,21,37,20,20,0,40,0,12,5,7,28
KARNATAKA,INSULT TO MODESTY OF WOMEN (SECTION 509 IPC),130,100,0,0,9,150,2,152,69,72,150,0,222,1,108,1,107,113
KERALA,INSULT TO MODESTY OF WOMEN (SECTION 509 IPC),92,498,0,0,16,469,14,483,91,1265,469,0,1734,14,235,83,152,1485
MADHYA PRADESH,INSULT TO MODESTY OF WOMEN (SECTION 509 IPC),16,774,0,0,1,772,6,778,11,1701,772,2,2471,166,459,160,299,1846
MAHARASHTRA,INSULT TO MODESTY OF WOMEN (SECTION 509 IPC),502,1294,0,0,7,1044,27,1071,718,8436,1044,0,9480,264,543,30,513,8673
MANIPUR,INSULT TO MODESTY OF WOMEN (SECTION 509 IPC),1,1,0,0,0,0,0,0,2,1,0,0,1,0,0,0,0,1
MEGHALAYA,INSULT TO MODESTY OF WOMEN (SECTION 509 IPC),18,0,0,0,0,0,0,0,18,4,0,0,4,0,0,0,0,4
MIZORAM,INSULT TO MODESTY OF WOMEN (SECTION 509 IPC),1,0,0,0,0,1,0,1,0,0,1,0,1,0,1,1,0,0
NAGALAND,INSULT TO MODESTY OF WOMEN (SECTION 509 IPC),0,0,0,0,0,0,0,0,0,2,0,0,2,0,0,0,0,2
ODISHA,INSULT TO MODESTY OF WOMEN (SECTION 509 IPC),64,304,0,0,15,262,4,266,87,1241,262,0,1503,0,197,18,179,1306
PUNJAB,INSULT TO MODESTY OF WOMEN (SECTION 509 IPC),13,31,0,0,3,13,9,22,19,46,13,0,59,0,11,3,8,48
RAJASTHAN,INSULT TO MODESTY OF WOMEN (SECTION 509 IPC),0,18,0,0,2,15,0,15,1,88,15,0,103,0,9,5,4,94
SIKKIM,INSULT TO MODESTY OF WOMEN (SECTION 509 IPC),0,0,0,0,0,0,0,0,0,0,0,0,0,0,0,0,0,0
TAMIL NADU,INSULT TO MODESTY OF WOMEN (SECTION 509 IPC),167,382,0,0,14,351,36,387,148,971,351,0,1322,0,323,113,210,999
TRIPURA,INSULT TO MODESTY OF WOMEN (SECTION 509 IPC),3,7,0,0,0,10,0,10,0,10,10,0,20,0,4,1,3,16
UTTAR PRADESH,INSULT TO MODESTY OF WOMEN (SECTION 509 IPC),2,8,0,0,0,9,1,10,0,1719,9,0,1728,18,1452,826,626,258
UTTARAKHAND,INSULT TO MODESTY OF WOMEN (SECTION 509 IPC),2,73,0,0,1,67,2,69,5,454,67,0,521,2,63,49,14,456
WEST BENGAL,INSULT TO MODESTY OF WOMEN (SECTION 509 IPC),127,556,0,0,5,380,78,458,220,119,380,0,499,19,229,96,133,251
TOTAL (STATES),INSULT TO MODESTY OF WOMEN (SECTION 509 IPC),1907,8934,0,0,338,7754,314,8068,2435,24415,7754,2,32167,1324,6784,2502,4282,24059
A & N ISLANDS,INSULT TO MODESTY OF WOMEN (SECTION 509 IPC),3,4,0,0,0,4,0,4,3,33,4,0,37,0,1,0,1,36
CHANDIGARH,INSULT TO MODESTY OF WOMEN (SECTION 509 IPC),3,25,0,0,1,15,1,16,11,25,15,0,40,0,6,0,6,34
D & N HAVELI,INSULT TO MODESTY OF WOMEN (SECTION 509 IPC),0,0,0,0,0,0,0,0,0,3,0,0,3,0,1,0,1,2
DAMAN & DIU,INSULT TO MODESTY OF WOMEN (SECTION 509 IPC),0,0,0,0,0,0,0,0,0,2,0,0,2,1,1,0,1,0
DELHI,INSULT TO MODESTY OF WOMEN (SECTION 509 IPC),105,208,0,0,0,158,10,168,145,529,158,0,687,0,148,63,85,539
LAKSHADWEEP,INSULT TO MODESTY OF WOMEN (SECTION 509 IPC),0,0,0,0,0,0,0,0,0,0,0,0,0,0,0,0,0,0
PUDUCHERRY,INSULT TO MODESTY OF WOMEN (SECTION 509 IPC),5,2,0,0,0,6,0,6,1,92,6,0,98,0,15,1,14,83
TOTAL (UTs),INSULT TO MODESTY OF WOMEN (SECTION 509 IPC),116,239,0,0,1,183,11,194,160,684,183,0,867,1,172,64,108,694
TOTAL (ALL-INDIA),INSULT TO MODESTY OF WOMEN (SECTION 509 IPC),2023,9173,0,0,339,7937,325,8262,2595,25099,7937,2,33034,1325,6956,2566,4390,24753
ANDHRA PRADESH,CRUELTY BY HUSBAND AND RELATIVES (SECTION 498-A IPC),4700,13389,0,0,1049,10689,711,11400,5640,21962,10689,1,32650,3510,6506,661,5845,22634
ARUNACHAL PRADESH,CRUELTY BY HUSBAND AND RELATIVES (SECTION 498-A IPC),12,26,0,0,0,20,4,24,14,92,20,0,112,2,4,2,2,106
ASSAM,CRUELTY BY HUSBAND AND RELATIVES (SECTION 498-A IPC),4509,6407,0,107,376,3971,1070,5041,5392,8081,3971,0,12052,237,2135,205,1930,9680
BIHAR,CRUELTY BY HUSBAND AND RELATIVES (SECTION 498-A IPC),2778,3686,0,0,570,3125,509,3634,2260,6029,3125,0,9154,249,948,171,777,7957
CHHATTISGARH,CRUELTY BY HUSBAND AND RELATIVES (SECTION 498-A IPC),84,980,0,0,1,957,5,962,101,4592,957,0,5549,72,845,242,603,4632
GOA,CRUELTY BY HUSBAND AND RELATIVES (SECTION 498-A IPC),21,24,0,0,0,7,5,12,33,53,7,0,60,0,7,1,6,53
GUJARAT,CRUELTY BY HUSBAND AND RELATIVES (SECTION 498-A IPC),700,6658,3,5,9,6522,11,6533,808,39723,6522,0,46245,200,3186,110,3076,42859
HARYANA,CRUELTY BY HUSBAND AND RELATIVES (SECTION 498-A IPC),868,3137,0,0,834,2011,279,2290,881,6804,2011,0,8815,46,2026,188,1838,6743
HIMACHAL PRADESH,CRUELTY BY HUSBAND AND RELATIVES (SECTION 498-A IPC),68,251,0,0,41,215,2,217,61,1317,215,0,1532,68,168,6,162,1296
JAMMU & KASHMIR,CRUELTY BY HUSBAND AND RELATIVES (SECTION 498-A IPC),106,301,0,1,25,273,0,273,108,618,273,0,891,60,82,2,80,749
JHARKHAND,CRUELTY BY HUSBAND AND RELATIVES (SECTION 498-A IPC),538,1261,0,0,31,929,137,1066,702,895,929,0,1824,49,612,156,456,1163
KARNATAKA,CRUELTY BY HUSBAND AND RELATIVES (SECTION 498-A IPC),924,3684,0,26,223,3162,79,3241,1118,7909,3162,27,11044,105,2126,71,2055,8813
KERALA,CRUELTY BY HUSBAND AND RELATIVES (SECTION 498-A IPC),1515,5216,0,2,206,5026,100,5126,1397,18292,5026,0,23318,93,2381,168,2213,20844
MADHYA PRADESH,CRUELTY BY HUSBAND AND RELATIVES (SECTION 498-A IPC),192,3988,0,0,3,3970,16,3986,191,11690,3970,27,15633,917,2095,697,1398,12621
MAHARASHTRA,CRUELTY BY HUSBAND AND RELATIVES (SECTION 498-A IPC),2249,7415,0,4,107,6946,130,7076,2477,54436,6946,0,61382,673,6109,113,5996,54600
MANIPUR,CRUELTY BY HUSBAND AND RELATIVES (SECTION 498-A IPC),129,43,0,0,0,7,11,18,154,4,7,0,11,0,0,0,0,11
MEGHALAYA,CRUELTY BY HUSBAND AND RELATIVES (SECTION 498-A IPC),46,16,0,0,0,8,2,10,52,44,8,0,52,0,0,0,0,52
MIZORAM,CRUELTY BY HUSBAND AND RELATIVES (SECTION 498-A IPC),2,8,0,0,0,7,0,7,3,1,7,0,8,0,8,7,1,0
NAGALAND,CRUELTY BY HUSBAND AND RELATIVES (SECTION 498-A IPC),0,0,0,0,0,0,0,0,0,1,0,0,1,0,0,0,0,1
ODISHA,CRUELTY BY HUSBAND AND RELATIVES (SECTION 498-A IPC),1041,2638,0,0,50,2364,53,2417,1212,8570,2364,0,10934,0,1350,146,1204,9584
PUNJAB,CRUELTY BY HUSBAND AND RELATIVES (SECTION 498-A IPC),777,1293,0,0,99,718,143,861,1110,3696,718,0,4414,0,443,113,330,3971
RAJASTHAN,CRUELTY BY HUSBAND AND RELATIVES (SECTION 498-A IPC),440,13312,0,1,6241,6934,30,6964,546,26639,6934,0,33573,1196,4060,1480,2580,28317
SIKKIM,CRUELTY BY HUSBAND AND RELATIVES (SECTION 498-A IPC),3,4,0,0,0,2,4,6,1,15,2,0,17,0,7,3,4,10
TAMIL NADU,CRUELTY BY HUSBAND AND RELATIVES (SECTION 498-A IPC),926,1965,0,0,102,1496,139,1635,1154,4036,1496,0,5532,2,1035,203,832,4495
TRIPURA,CRUELTY BY HUSBAND AND RELATIVES (SECTION 498-A IPC),91,858,0,0,3,793,69,862,84,2362,793,558,2597,150,1418,213,1205,1029
UTTAR PRADESH,CRUELTY BY HUSBAND AND RELATIVES (SECTION 498-A IPC),869,7661,0,0,130,4461,1435,5896,2504,14573,4461,0,19034,463,2866,1414,1452,15705
UTTARAKHAND,CRUELTY BY HUSBAND AND RELATIVES (SECTION 498-A IPC),70,368,0,0,13,255,70,325,100,1189,255,0,1444,24,186,122,64,1234
WEST BENGAL,CRUELTY BY HUSBAND AND RELATIVES (SECTION 498-A IPC),11991,19865,0,5,69,21556,640,22196,9586,92303,21556,0,113859,43,4486,199,4287,109330
TOTAL (STATES),CRUELTY BY HUSBAND AND RELATIVES (SECTION 498-A IPC),35649,104454,3,151,10182,86424,5654,92078,37689,335926,86424,613,421737,8159,45089,6693,38396,368489
A & N ISLANDS,CRUELTY BY HUSBAND AND RELATIVES (SECTION 498-A IPC),5,5,0,0,0,3,2,5,5,67,3,0,70,0,1,0,1,69
CHANDIGARH,CRUELTY BY HUSBAND AND RELATIVES (SECTION 498-A IPC),70,73,0,0,6,55,5,60,77,248,55,0,303,0,54,8,46,249
D & N HAVELI,CRUELTY BY HUSBAND AND RELATIVES (SECTION 498-A IPC),5,0,1,0,0,1,0,1,3,19,1,0,20,0,3,0,3,17
DAMAN & DIU,CRUELTY BY HUSBAND AND RELATIVES (SECTION 498-A IPC),2,3,0,0,0,2,0,2,3,11,2,0,13,0,2,0,2,11
DELHI,CRUELTY BY HUSBAND AND RELATIVES (SECTION 498-A IPC),5066,1985,57,3,47,1143,319,1462,5482,3592,1143,0,4735,0,897,215,682,3838
LAKSHADWEEP,CRUELTY BY HUSBAND AND RELATIVES (SECTION 498-A IPC),0,1,0,0,0,0,0,0,1,3,0,0,3,3,0,0,0,0
PUDUCHERRY,CRUELTY BY HUSBAND AND RELATIVES (SECTION 498-A IPC),5,6,0,1,0,5,0,5,5,36,5,0,41,0,8,0,8,33
TOTAL (UTs),CRUELTY BY HUSBAND AND RELATIVES (SECTION 498-A IPC),5153,2073,58,4,53,1209,326,1535,5576,3976,1209,0,5185,3,965,223,742,4217
TOTAL (ALL-INDIA),CRUELTY BY HUSBAND AND RELATIVES (SECTION 498-A IPC),40802,106527,61,155,10235,87633,5980,93613,43265,339902,87633,613,426922,8162,46054,6916,39138,372706
ANDHRA PRADESH,IMPORTATION OF GIRLS (SECTION 366-B IPC),0,0,0,0,0,0,0,0,0,1,0,0,1,0,0,0,0,1
ARUNACHAL PRADESH,IMPORTATION OF GIRLS (SECTION 366-B IPC),0,0,0,0,0,0,0,0,0,0,0,0,0,0,0,0,0,0
ASSAM,IMPORTATION OF GIRLS (SECTION 366-B IPC),0,2,0,0,0,0,0,0,2,4,0,0,4,0,2,0,2,2
BIHAR,IMPORTATION OF GIRLS (SECTION 366-B IPC),9,4,0,0,1,3,0,3,9,202,3,0,205,0,43,6,37,162
CHHATTISGARH,IMPORTATION OF GIRLS (SECTION 366-B IPC),1,0,0,0,0,1,0,1,0,3,1,0,4,0,1,1,0,3
GOA,IMPORTATION OF GIRLS (SECTION 366-B IPC),0,0,0,0,0,0,0,0,0,0,0,0,0,0,0,0,0,0
GUJARAT,IMPORTATION OF GIRLS (SECTION 366-B IPC),0,0,0,0,0,0,0,0,0,0,0,0,0,0,0,0,0,0
HARYANA,IMPORTATION OF GIRLS (SECTION 366-B IPC),0,0,0,0,0,0,0,0,0,0,0,0,0,0,0,0,0,0
HIMACHAL PRADESH,IMPORTATION OF GIRLS (SECTION 366-B IPC),0,0,0,0,0,0,0,0,0,0,0,0,0,0,0,0,0,0
JAMMU & KASHMIR,IMPORTATION OF GIRLS (SECTION 366-B IPC),0,0,0,0,0,0,0,0,0,0,0,0,0,0,0,0,0,0
JHARKHAND,IMPORTATION OF GIRLS (SECTION 366-B IPC),0,3,0,0,0,3,0,3,0,7,3,0,10,1,3,1,2,6
KARNATAKA,IMPORTATION OF GIRLS (SECTION 366-B IPC),11,32,0,0,2,0,0,0,41,1,0,0,1,0,0,0,0,1
KERALA,IMPORTATION OF GIRLS (SECTION 366-B IPC),0,0,0,0,0,0,0,0,0,0,0,0,0,0,0,0,0,0
MADHYA PRADESH,IMPORTATION OF GIRLS (SECTION 366-B IPC),5,6,0,0,0,9,1,10,1,45,9,0,54,8,5,1,4,41
MAHARASHTRA,IMPORTATION OF GIRLS (SECTION 366-B IPC),0,0,0,0,0,0,0,0,0,0,0,0,0,0,0,0,0,0
MANIPUR,IMPORTATION OF GIRLS (SECTION 366-B IPC),0,0,0,0,0,0,0,0,0,0,0,0,0,0,0,0,0,0
MEGHALAYA,IMPORTATION OF GIRLS (SECTION 366-B IPC),2,0,0,0,0,2,0,2,0,0,2,0,2,0,0,0,0,2
MIZORAM,IMPORTATION OF GIRLS (SECTION 366-B IPC),0,0,0,0,0,0,0,0,0,0,0,0,0,0,0,0,0,0
NAGALAND,IMPORTATION OF GIRLS (SECTION 366-B IPC),0,0,0,0,0,0,0,0,0,0,0,0,0,0,0,0,0,0
ODISHA,IMPORTATION OF GIRLS (SECTION 366-B IPC),0,0,0,0,0,0,0,0,0,17,0,0,17,0,0,0,0,17
PUNJAB,IMPORTATION OF GIRLS (SECTION 366-B IPC),0,0,0,0,0,0,0,0,0,0,0,0,0,0,0,0,0,0
RAJASTHAN,IMPORTATION OF GIRLS (SECTION 366-B IPC),0,0,0,0,0,0,0,0,0,1,0,0,1,0,0,0,0,1
SIKKIM,IMPORTATION OF GIRLS (SECTION 366-B IPC),0,0,0,0,0,0,0,0,0,0,0,0,0,0,0,0,0,0
TAMIL NADU,IMPORTATION OF GIRLS (SECTION 366-B IPC),0,0,0,0,0,0,0,0,0,0,0,0,0,0,0,0,0,0
TRIPURA,IMPORTATION OF GIRLS (SECTION 366-B IPC),0,0,0,0,0,0,0,0,0,0,0,0,0,0,0,0,0,0
UTTAR PRADESH,IMPORTATION OF GIRLS (SECTION 366-B IPC),0,0,0,0,0,0,0,0,0,0,0,0,0,0,0,0,0,0
UTTARAKHAND,IMPORTATION OF GIRLS (SECTION 366-B IPC),0,0,0,0,0,0,0,0,0,0,0,0,0,0,0,0,0,0
WEST BENGAL,IMPORTATION OF GIRLS (SECTION 366-B IPC),6,12,0,0,0,9,2,11,7,13,9,0,22,0,8,1,7,14
TOTAL (STATES),IMPORTATION OF GIRLS (SECTION 366-B IPC),34,59,0,0,3,27,3,30,60,294,27,0,321,9,62,10,52,250
A & N ISLANDS,IMPORTATION OF GIRLS (SECTION 366-B IPC),0,0,0,0,0,0,0,0,0,0,0,0,0,0,0,0,0,0
CHANDIGARH,IMPORTATION OF GIRLS (SECTION 366-B IPC),0,0,0,0,0,0,0,0,0,0,0,0,0,0,0,0,0,0
D & N HAVELI,IMPORTATION OF GIRLS (SECTION 366-B IPC),0,0,0,0,0,0,0,0,0,0,0,0,0,0,0,0,0,0
DAMAN & DIU,IMPORTATION OF GIRLS (SECTION 366-B IPC),0,0,0,0,0,0,0,0,0,0,0,0,0,0,0,0,0,0
DELHI,IMPORTATION OF GIRLS (SECTION 366-B IPC),1,0,0,0,0,0,0,0,1,0,0,0,0,0,0,0,0,0
LAKSHADWEEP,IMPORTATION OF GIRLS (SECTION 366-B IPC),0,0,0,0,0,0,0,0,0,0,0,0,0,0,0,0,0,0
PUDUCHERRY,IMPORTATION OF GIRLS (SECTION 366-B IPC),0,0,0,0,0,0,0,0,0,0,0,0,0,0,0,0,0,0
TOTAL (UTs),IMPORTATION OF GIRLS (SECTION 366-B IPC),1,0,0,0,0,0,0,0,1,0,0,0,0,0,0,0,0,0
TOTAL (ALL-INDIA),IMPORTATION OF GIRLS (SECTION 366-B IPC),35,59,0,0,3,27,3,30,61,294,27,0,321,9,62,10,52,250
ANDHRA PRADESH,SATI PREVENTION ACT,0,0,0,0,0,0,0,0,0,0,0,0,0,0,0,0,0,0
ARUNACHAL PRADESH,SATI PREVENTION ACT,0,0,0,0,0,0,0,0,0,0,0,0,0,0,0,0,0,0
ASSAM,SATI PREVENTION ACT,0,0,0,0,0,0,0,0,0,0,0,0,0,0,0,0,0,0
BIHAR,SATI PREVENTION ACT,0,0,0,0,0,0,0,0,0,0,0,0,0,0,0,0,0,0
CHHATTISGARH,SATI PREVENTION ACT,0,0,0,0,0,0,0,0,0,0,0,0,0,0,0,0,0,0
GOA,SATI PREVENTION ACT,0,0,0,0,0,0,0,0,0,0,0,0,0,0,0,0,0,0
GUJARAT,SATI PREVENTION ACT,0,0,0,0,0,0,0,0,0,0,0,0,0,0,0,0,0,0
HARYANA,SATI PREVENTION ACT,0,0,0,0,0,0,0,0,0,0,0,0,0,0,0,0,0,0
HIMACHAL PRADESH,SATI PREVENTION ACT,0,0,0,0,0,0,0,0,0,0,0,0,0,0,0,0,0,0
JAMMU & KASHMIR,SATI PREVENTION ACT,0,0,0,0,0,0,0,0,0,0,0,0,0,0,0,0,0,0
JHARKHAND,SATI PREVENTION ACT,0,0,0,0,0,0,0,0,0,0,0,0,0,0,0,0,0,0
KARNATAKA,SATI PREVENTION ACT,0,0,0,0,0,0,0,0,0,0,0,0,0,0,0,0,0,0
KERALA,SATI PREVENTION ACT,0,0,0,0,0,0,0,0,0,0,0,0,0,0,0,0,0,0
MADHYA PRADESH,SATI PREVENTION ACT,0,0,0,0,0,0,0,0,0,0,0,0,0,0,0,0,0,0
MAHARASHTRA,SATI PREVENTION ACT,0,0,0,0,0,0,0,0,0,0,0,0,0,0,0,0,0,0
MANIPUR,SATI PREVENTION ACT,0,0,0,0,0,0,0,0,0,0,0,0,0,0,0,0,0,0
MEGHALAYA,SATI PREVENTION ACT,0,0,0,0,0,0,0,0,0,0,0,0,0,0,0,0,0,0
MIZORAM,SATI PREVENTION ACT,0,0,0,0,0,0,0,0,0,0,0,0,0,0,0,0,0,0
NAGALAND,SATI PREVENTION ACT,0,0,0,0,0,0,0,0,0,0,0,0,0,0,0,0,0,0
ODISHA,SATI PREVENTION ACT,0,0,0,0,0,0,0,0,0,0,0,0,0,0,0,0,0,0
PUNJAB,SATI PREVENTION ACT,0,0,0,0,0,0,0,0,0,0,0,0,0,0,0,0,0,0
RAJASTHAN,SATI PREVENTION ACT,0,0,0,0,0,0,0,0,0,1,0,0,1,0,0,0,0,1
SIKKIM,SATI PREVENTION ACT,0,0,0,0,0,0,0,0,0,0,0,0,0,0,0,0,0,0
TAMIL NADU,SATI PREVENTION ACT,0,0,0,0,0,0,0,0,0,0,0,0,0,0,0,0,0,0
TRIPURA,SATI PREVENTION ACT,0,0,0,0,0,0,0,0,0,0,0,0,0,0,0,0,0,0
UTTAR PRADESH,SATI PREVENTION ACT,0,0,0,0,0,0,0,0,0,0,0,0,0,0,0,0,0,0
UTTARAKHAND,SATI PREVENTION ACT,0,0,0,0,0,0,0,0,0,0,0,0,0,0,0,0,0,0
WEST BENGAL,SATI PREVENTION ACT,0,0,0,0,0,0,0,0,0,0,0,0,0,0,0,0,0,0
TOTAL (STATES),SATI PREVENTION ACT,0,0,0,0,0,0,0,0,0,1,0,0,1,0,0,0,0,1
A & N ISLANDS,SATI PREVENTION ACT,0,0,0,0,0,0,0,0,0,0,0,0,0,0,0,0,0,0
CHANDIGARH,SATI PREVENTION ACT,0,0,0,0,0,0,0,0,0,0,0,0,0,0,0,0,0,0
D & N HAVELI,SATI PREVENTION ACT,0,0,0,0,0,0,0,0,0,0,0,0,0,0,0,0,0,0
DAMAN & DIU,SATI PREVENTION ACT,0,0,0,0,0,0,0,0,0,0,0,0,0,0,0,0,0,0
DELHI,SATI PREVENTION ACT,0,0,0,0,0,0,0,0,0,0,0,0,0,0,0,0,0,0
LAKSHADWEEP,SATI PREVENTION ACT,0,0,0,0,0,0,0,0,0,0,0,0,0,0,0,0,0,0
PUDUCHERRY,SATI PREVENTION ACT,0,0,0,0,0,0,0,0,0,0,0,0,0,0,0,0,0,0
TOTAL (UTs),SATI PREVENTION ACT,0,0,0,0,0,0,0,0,0,0,0,0,0,0,0,0,0,0
TOTAL (ALL-INDIA),SATI PREVENTION ACT,0,0,0,0,0,0,0,0,0,1,0,0,1,0,0,0,0,1
ANDHRA PRADESH,IMMORAL TRAFFIC (PREVENTION) ACT,214,472,0,0,0,492,2,494,192,1065,492,0,1557,1,624,214,410,932
ARUNACHAL PRADESH,IMMORAL TRAFFIC (PREVENTION) ACT,0,1,0,0,0,0,0,0,1,1,0,0,1,0,0,0,0,1
ASSAM,IMMORAL TRAFFIC (PREVENTION) ACT,45,30,0,1,0,16,6,22,52,75,16,0,91,0,9,0,9,82
BIHAR,IMMORAL TRAFFIC (PREVENTION) ACT,36,35,0,0,0,26,6,32,39,126,26,0,152,0,15,3,12,137
CHHATTISGARH,IMMORAL TRAFFIC (PREVENTION) ACT,0,5,0,0,0,5,0,5,0,47,5,0,52,0,18,15,3,34
GOA,IMMORAL TRAFFIC (PREVENTION) ACT,15,40,0,0,0,9,1,10,45,49,9,0,58,0,4,2,2,54
GUJARAT,IMMORAL TRAFFIC (PREVENTION) ACT,4,44,0,0,0,33,0,33,15,594,33,0,627,0,5,0,5,622
HARYANA,IMMORAL TRAFFIC (PREVENTION) ACT,10,69,0,0,1,69,0,69,9,353,69,0,422,0,113,20,93,309
HIMACHAL PRADESH,IMMORAL TRAFFIC (PREVENTION) ACT,0,6,0,0,0,4,0,4,2,13,4,0,17,0,2,0,2,15
JAMMU & KASHMIR,IMMORAL TRAFFIC (PREVENTION) ACT,8,3,0,0,1,4,0,4,6,32,4,0,36,0,4,0,4,32
JHARKHAND,IMMORAL TRAFFIC (PREVENTION) ACT,3,12,0,0,0,9,0,9,6,19,9,0,28,0,2,1,1,26
KARNATAKA,IMMORAL TRAFFIC (PREVENTION) ACT,30,335,0,0,0,276,0,276,89,1339,276,0,1615,0,292,100,192,1323
KERALA,IMMORAL TRAFFIC (PREVENTION) ACT,23,210,0,0,0,219,0,219,14,833,219,0,1052,0,192,105,87,860
MADHYA PRADESH,IMMORAL TRAFFIC (PREVENTION) ACT,2,13,0,0,0,13,0,13,2,93,13,0,106,0,19,6,13,87
MAHARASHTRA,IMMORAL TRAFFIC (PREVENTION) ACT,718,366,0,0,0,328,3,331,753,3264,328,0,3592,4,55,20,35,3533
MANIPUR,IMMORAL TRAFFIC (PREVENTION) ACT,0,15,0,0,0,0,0,0,15,0,0,0,0,0,0,0,0,0
MEGHALAYA,IMMORAL TRAFFIC (PREVENTION) ACT,6,7,0,0,0,0,1,1,12,2,0,0,2,0,0,0,0,2
MIZORAM,IMMORAL TRAFFIC (PREVENTION) ACT,5,0,0,0,0,0,0,0,5,2,0,0,2,0,2,2,0,0
NAGALAND,IMMORAL TRAFFIC (PREVENTION) ACT,0,4,0,0,0,4,0,4,0,1,4,0,5,0,2,2,0,3
ODISHA,IMMORAL TRAFFIC (PREVENTION) ACT,14,24,0,0,0,20,0,20,18,115,20,0,135,0,18,1,17,117
PUNJAB,IMMORAL TRAFFIC (PREVENTION) ACT,40,86,0,0,0,68,0,68,58,172,68,0,240,0,47,11,36,193
RAJASTHAN,IMMORAL TRAFFIC (PREVENTION) ACT,4,99,0,0,0,96,1,97,6,574,96,0,670,0,36,20,16,634
SIKKIM,IMMORAL TRAFFIC (PREVENTION) ACT,2,0,0,0,0,2,0,2,0,4,2,0,6,0,6,4,2,0
TAMIL NADU,IMMORAL TRAFFIC (PREVENTION) ACT,101,500,0,0,0,333,0,333,268,507,333,0,840,0,238,153,85,602
TRIPURA,IMMORAL TRAFFIC (PREVENTION) ACT,0,0,0,0,0,0,0,0,0,0,0,0,0,0,0,0,0,0
UTTAR PRADESH,IMMORAL TRAFFIC (PREVENTION) ACT,5,31,0,0,0,32,0,32,4,141,32,0,173,0,17,13,4,156
UTTARAKHAND,IMMORAL TRAFFIC (PREVENTION) ACT,0,12,0,0,0,9,0,9,3,9,9,0,18,0,3,3,0,15
WEST BENGAL,IMMORAL TRAFFIC (PREVENTION) ACT,139,109,0,0,0,103,3,106,142,201,103,0,304,0,44,18,26,260
TOTAL (STATES),IMMORAL TRAFFIC (PREVENTION) ACT,1424,2528,0,1,2,2170,23,2193,1756,9631,2170,0,11801,5,1767,713,1054,10029
A & N ISLANDS,IMMORAL TRAFFIC (PREVENTION) ACT,6,2,0,0,0,6,0,6,2,6,6,0,12,0,0,0,0,12
CHANDIGARH,IMMORAL TRAFFIC (PREVENTION) ACT,1,0,0,0,0,1,0,1,0,37,1,0,38,0,4,0,4,34
D & N HAVELI,IMMORAL TRAFFIC (PREVENTION) ACT,1,2,0,0,0,3,0,3,0,8,3,0,11,0,0,0,0,11
DAMAN & DIU,IMMORAL TRAFFIC (PREVENTION) ACT,10,3,0,0,0,5,0,5,8,18,5,0,23,0,1,0,1,22
DELHI,IMMORAL TRAFFIC (PREVENTION) ACT,28,24,0,0,0,25,0,25,27,401,25,0,426,0,43,31,12,383
LAKSHADWEEP,IMMORAL TRAFFIC (PREVENTION) ACT,0,0,0,0,0,0,0,0,0,0,0,0,0,0,0,0,0,0
PUDUCHERRY,IMMORAL TRAFFIC (PREVENTION) ACT,0,4,0,0,0,0,0,0,4,14,0,0,14,0,2,2,0,12
TOTAL (UTs),IMMORAL TRAFFIC (PREVENTION) ACT,46,35,0,0,0,40,0,40,41,484,40,0,524,0,50,33,17,474
TOTAL (ALL-INDIA),IMMORAL TRAFFIC (PREVENTION) ACT,1470,2563,0,1,2,2210,23,2233,1797,10115,2210,0,12325,5,1817,746,1071,10503
ANDHRA PRADESH,INDECENT REPRESENTATION OF WOMEN (PROHIBITION) ACT,2,21,0,0,0,17,1,18,5,27,17,0,44,0,20,16,4,24
ARUNACHAL PRADESH,INDECENT REPRESENTATION OF WOMEN (PROHIBITION) ACT,0,0,0,0,0,0,0,0,0,0,0,0,0,0,0,0,0,0
ASSAM,INDECENT REPRESENTATION OF WOMEN (PROHIBITION) ACT,2,3,0,0,0,2,0,2,3,1,2,0,3,0,0,0,0,3
BIHAR,INDECENT REPRESENTATION OF WOMEN (PROHIBITION) ACT,0,5,0,0,0,2,3,5,0,48,2,0,50,0,2,0,2,48
CHHATTISGARH,INDECENT REPRESENTATION OF WOMEN (PROHIBITION) ACT,0,1,0,0,0,1,0,1,0,1,1,0,2,0,0,0,0,2
GOA,INDECENT REPRESENTATION OF WOMEN (PROHIBITION) ACT,0,0,0,0,0,0,0,0,0,4,0,0,4,0,0,0,0,4
GUJARAT,INDECENT REPRESENTATION OF WOMEN (PROHIBITION) ACT,0,0,0,0,0,0,0,0,0,77,0,0,77,0,7,4,3,70
HARYANA,INDECENT REPRESENTATION OF WOMEN (PROHIBITION) ACT,0,2,0,0,0,2,0,2,0,0,2,0,2,0,0,0,0,2
HIMACHAL PRADESH,INDECENT REPRESENTATION OF WOMEN (PROHIBITION) ACT,0,0,0,0,0,0,0,0,0,0,0,0,0,0,0,0,0,0
JAMMU & KASHMIR,INDECENT REPRESENTATION OF WOMEN (PROHIBITION) ACT,0,0,0,0,0,0,0,0,0,2,0,0,2,0,0,0,0,2
JHARKHAND,INDECENT REPRESENTATION OF WOMEN (PROHIBITION) ACT,3,0,0,0,0,0,0,0,3,3,0,0,3,0,0,0,0,3
KARNATAKA,INDECENT REPRESENTATION OF WOMEN (PROHIBITION) ACT,2,0,0,0,1,0,0,0,1,0,0,0,0,0,0,0,0,0
KERALA,INDECENT REPRESENTATION OF WOMEN (PROHIBITION) ACT,11,3,0,0,0,6,2,8,6,112,6,0,118,0,21,4,17,97
MADHYA PRADESH,INDECENT REPRESENTATION OF WOMEN (PROHIBITION) ACT,0,0,0,0,0,0,0,0,0,0,0,0,0,0,0,0,0,0
MAHARASHTRA,INDECENT REPRESENTATION OF WOMEN (PROHIBITION) ACT,0,2,0,0,0,2,0,2,0,56,2,0,58,0,2,0,2,56
MANIPUR,INDECENT REPRESENTATION OF WOMEN (PROHIBITION) ACT,0,0,0,0,0,0,0,0,0,0,0,0,0,0,0,0,0,0
MEGHALAYA,INDECENT REPRESENTATION OF WOMEN (PROHIBITION) ACT,0,0,0,0,0,0,0,0,0,0,0,0,0,0,0,0,0,0
MIZORAM,INDECENT REPRESENTATION OF WOMEN (PROHIBITION) ACT,0,0,0,0,0,0,0,0,0,0,0,0,0,0,0,0,0,0
NAGALAND,INDECENT REPRESENTATION OF WOMEN (PROHIBITION) ACT,0,0,0,0,0,0,0,0,0,0,0,0,0,0,0,0,0,0
ODISHA,INDECENT REPRESENTATION OF WOMEN (PROHIBITION) ACT,1,1,0,0,0,1,0,1,1,2,1,0,3,0,0,0,0,3
PUNJAB,INDECENT REPRESENTATION OF WOMEN (PROHIBITION) ACT,0,0,0,0,0,0,0,0,0,4,0,0,4,0,0,0,0,4
RAJASTHAN,INDECENT REPRESENTATION OF WOMEN (PROHIBITION) ACT,0,62,0,0,0,59,1,60,2,628,59,0,687,0,57,44,13,630
SIKKIM,INDECENT REPRESENTATION OF WOMEN (PROHIBITION) ACT,0,0,0,0,0,0,0,0,0,0,0,0,0,0,0,0,0,0
TAMIL NADU,INDECENT REPRESENTATION OF WOMEN (PROHIBITION) ACT,9,34,0,0,0,24,0,24,19,10,24,0,34,0,17,10,7,17
TRIPURA,INDECENT REPRESENTATION OF WOMEN (PROHIBITION) ACT,0,0,0,0,0,0,0,0,0,0,0,0,0,0,0,0,0,0
UTTAR PRADESH,INDECENT REPRESENTATION OF WOMEN (PROHIBITION) ACT,1,0,0,0,0,0,1,1,0,3,0,0,3,0,1,1,0,2
UTTARAKHAND,INDECENT REPRESENTATION OF WOMEN (PROHIBITION) ACT,0,0,0,0,0,0,0,0,0,0,0,0,0,0,0,0,0,0
WEST BENGAL,INDECENT REPRESENTATION OF WOMEN (PROHIBITION) ACT,8,7,0,0,0,6,0,6,9,21,6,0,27,0,3,0,3,24
TOTAL (STATES),INDECENT REPRESENTATION OF WOMEN (PROHIBITION) ACT,39,141,0,0,1,122,8,130,49,999,122,0,1121,0,130,79,51,991
A & N ISLANDS,INDECENT REPRESENTATION OF WOMEN (PROHIBITION) ACT,0,0,0,0,0,0,0,0,0,0,0,0,0,0,0,0,0,0
CHANDIGARH,INDECENT REPRESENTATION OF WOMEN (PROHIBITION) ACT,1,0,0,0,0,0,0,0,1,1,0,0,1,0,0,0,0,1
D & N HAVELI,INDECENT REPRESENTATION OF WOMEN (PROHIBITION) ACT,0,0,0,0,0,0,0,0,0,0,0,0,0,0,0,0,0,0
DAMAN & DIU,INDECENT REPRESENTATION OF WOMEN (PROHIBITION) ACT,0,0,0,0,0,0,0,0,0,0,0,0,0,0,0,0,0,0
DELHI,INDECENT REPRESENTATION OF WOMEN (PROHIBITION) ACT,4,0,0,0,0,0,0,0,4,5,0,0,5,0,0,0,0,5
LAKSHADWEEP,INDECENT REPRESENTATION OF WOMEN (PROHIBITION) ACT,0,0,0,0,0,0,0,0,0,1,0,0,1,0,1,0,1,0
PUDUCHERRY,INDECENT REPRESENTATION OF WOMEN (PROHIBITION) ACT,0,0,0,0,0,0,0,0,0,0,0,0,0,0,0,0,0,0
TOTAL (UTs),INDECENT REPRESENTATION OF WOMEN (PROHIBITION) ACT,5,0,0,0,0,0,0,0,5,7,0,0,7,0,1,0,1,6
TOTAL (ALL-INDIA),INDECENT REPRESENTATION OF WOMEN (PROHIBITION) ACT,44,141,0,0,1,122,8,130,54,1006,122,0,1128,0,131,79,52,997
ANDHRA PRADESH,DOWRY PROHIBITION ACT,760,2511,0,0,91,2076,41,2117,1063,2654,2076,0,4730,318,1144,31,1113,3268
ARUNACHAL PRADESH,DOWRY PROHIBITION ACT,0,0,0,0,0,0,0,0,0,0,0,0,0,0,0,0,0,0
ASSAM,DOWRY PROHIBITION ACT,57,41,0,0,0,29,4,33,65,187,29,0,216,0,8,1,7,208
BIHAR,DOWRY PROHIBITION ACT,1305,1353,0,0,276,1203,171,1374,1008,4745,1203,0,5948,145,506,115,391,5297
CHHATTISGARH,DOWRY PROHIBITION ACT,2,14,0,0,0,16,0,16,0,26,16,0,42,2,9,3,6,31
GOA,DOWRY PROHIBITION ACT,0,0,0,0,0,0,0,0,0,0,0,0,0,0,0,0,0,0
GUJARAT,DOWRY PROHIBITION ACT,5,0,0,0,0,5,0,5,0,29,5,0,34,0,7,0,7,27
HARYANA,DOWRY PROHIBITION ACT,4,9,0,0,4,6,1,7,2,22,6,0,28,0,8,3,5,20
HIMACHAL PRADESH,DOWRY PROHIBITION ACT,0,0,0,0,0,0,0,0,0,15,0,0,15,0,0,0,0,15
JAMMU & KASHMIR,DOWRY PROHIBITION ACT,9,3,0,0,0,1,0,1,11,18,1,0,19,0,0,0,0,19
JHARKHAND,DOWRY PROHIBITION ACT,333,1066,0,0,14,654,92,746,639,920,654,0,1574,23,495,117,378,1056
KARNATAKA,DOWRY PROHIBITION ACT,269,1328,0,13,82,844,32,876,626,2713,844,0,3557,25,622,23,599,2910
KERALA,DOWRY PROHIBITION ACT,8,3,0,0,0,5,0,5,6,15,5,0,20,0,0,0,0,20
MADHYA PRADESH,DOWRY PROHIBITION ACT,0,101,0,0,0,100,0,100,1,205,100,0,305,1,32,11,21,272
MAHARASHTRA,DOWRY PROHIBITION ACT,3,33,0,0,0,32,0,32,4,327,32,0,359,0,51,3,48,308
MANIPUR,DOWRY PROHIBITION ACT,0,0,0,0,0,0,0,0,0,0,0,0,0,0,0,0,0,0
MEGHALAYA,DOWRY PROHIBITION ACT,0,0,0,0,0,0,0,0,0,0,0,0,0,0,0,0,0,0
MIZORAM,DOWRY PROHIBITION ACT,0,0,0,0,0,0,0,0,0,0,0,0,0,0,0,0,0,0
NAGALAND,DOWRY PROHIBITION ACT,0,0,0,0,0,0,0,0,0,0,0,0,0,0,0,0,0,0
ODISHA,DOWRY PROHIBITION ACT,807,1487,1,0,39,1312,41,1353,901,4154,1312,0,5466,0,829,72,757,4637
PUNJAB,DOWRY PROHIBITION ACT,5,1,0,0,0,1,0,1,5,12,1,0,13,0,0,0,0,13
RAJASTHAN,DOWRY PROHIBITION ACT,0,39,0,0,19,20,0,20,0,5,20,0,25,0,1,1,0,24
SIKKIM,DOWRY PROHIBITION ACT,0,0,0,0,0,0,0,0,0,0,0,0,0,0,0,0,0,0
TAMIL NADU,DOWRY PROHIBITION ACT,84,277,0,0,18,267,5,272,71,568,267,0,835,0,318,212,106,517
TRIPURA,DOWRY PROHIBITION ACT,0,0,0,0,0,0,0,0,0,3,0,0,3,0,1,0,1,2
UTTAR PRADESH,DOWRY PROHIBITION ACT,10,505,0,0,23,247,63,310,182,580,247,0,827,1,124,73,51,702
UTTARAKHAND,DOWRY PROHIBITION ACT,0,0,0,0,0,0,0,0,0,5,0,0,5,0,2,0,2,3
WEST BENGAL,DOWRY PROHIBITION ACT,95,241,0,0,0,166,9,175,161,149,166,0,315,0,58,8,50,257
TOTAL (STATES),DOWRY PROHIBITION ACT,3756,9012,1,13,566,6984,459,7443,4745,17352,6984,0,24336,515,4215,673,3542,19606
A & N ISLANDS,DOWRY PROHIBITION ACT,0,0,0,0,0,0,0,0,0,1,0,0,1,0,0,0,0,1
CHANDIGARH,DOWRY PROHIBITION ACT,1,0,0,0,0,0,0,0,1,0,0,0,0,0,0,0,0,0
D & N HAVELI,DOWRY PROHIBITION ACT,0,0,0,0,0,0,0,0,0,1,0,0,1,0,0,0,0,1
DAMAN & DIU,DOWRY PROHIBITION ACT,0,0,0,0,0,0,0,0,0,0,0,0,0,0,0,0,0,0
DELHI,DOWRY PROHIBITION ACT,30,15,0,0,0,2,3,5,40,81,2,0,83,0,5,4,1,78
LAKSHADWEEP,DOWRY PROHIBITION ACT,0,0,0,0,0,0,0,0,0,0,0,0,0,0,0,0,0,0
PUDUCHERRY,DOWRY PROHIBITION ACT,8,11,0,0,1,7,0,7,11,33,7,0,40,0,5,0,5,35
TOTAL (UTs),DOWRY PROHIBITION ACT,39,26,0,0,1,9,3,12,52,116,9,0,125,0,10,4,6,115
TOTAL (ALL-INDIA),DOWRY PROHIBITION ACT,3795,9038,1,13,567,6993,462,7455,4797,17468,6993,0,24461,515,4225,677,3548,19721
ANDHRA PRADESH,TOTAL CRIMES ,9170,28171,0,0,2499,22524,1070,23594,11248,43556,22524,1,66079,5133,15543,2086,13457,45403
ARUNACHAL PRADESH,TOTAL CRIMES ,130,201,0,0,0,127,39,166,165,1454,127,0,1581,13,95,24,71,1473
ASSAM,TOTAL CRIMES ,13106,13544,0,306,722,7524,2985,10509,15113,19623,7524,0,27147,244,4153,430,3723,22750
BIHAR,TOTAL CRIMES ,9186,11229,0,0,2559,8970,1384,10354,7502,26281,8970,0,35251,446,3835,682,3153,30970
CHHATTISGARH,TOTAL CRIMES ,481,4228,0,6,21,4108,67,4175,507,18296,4108,0,22404,531,3466,1050,2416,18407
GOA,TOTAL CRIMES ,122,200,0,1,0,82,21,103,218,380,82,0,462,2,47,6,41,413
GUJARAT,TOTAL CRIMES ,1295,9561,4,17,80,9017,311,9328,1427,59942,9017,0,68959,259,4445,199,4246,64255
HARYANA,TOTAL CRIMES ,1446,6002,0,0,1424,4314,400,4714,1310,12219,4314,0,16533,46,4204,852,3352,12283
HIMACHAL PRADESH,TOTAL CRIMES ,286,912,0,0,172,745,34,779,247,3795,745,1,4539,106,533,72,461,3900
JAMMU & KASHMIR,TOTAL CRIMES ,908,3328,0,2,682,2639,37,2676,876,12110,2639,0,14749,320,2178,219,1959,12251
JHARKHAND,TOTAL CRIMES ,2356,4536,0,0,150,3234,535,3769,2973,5838,3234,0,9072,118,2566,764,1802,6388
KARNATAKA,TOTAL CRIMES ,2613,10366,0,52,733,8174,282,8456,3738,21392,8174,40,29526,317,5820,378,5442,23389
KERALA,TOTAL CRIMES ,3313,10930,0,3,492,10377,223,10600,3148,38226,10377,0,48603,234,4649,610,4039,43720
MADHYA PRADESH,TOTAL CRIMES ,1147,16832,0,0,77,16687,170,16857,1045,48683,16687,39,65331,3149,10275,3181,7094,51907
MAHARASHTRA,TOTAL CRIMES ,6542,16353,0,19,330,14746,429,15175,7371,117765,14746,0,132511,1601,10808,598,10210,120102
MANIPUR,TOTAL CRIMES ,967,304,0,0,0,25,138,163,1108,99,25,0,124,1,2,0,2,121
MEGHALAYA,TOTAL CRIMES ,671,255,0,0,0,147,31,178,748,903,147,0,1050,2,26,9,17,1022
MIZORAM,TOTAL CRIMES ,45,199,0,0,0,187,4,191,53,181,187,0,368,0,154,118,36,214
NAGALAND,TOTAL CRIMES ,12,51,0,0,0,41,6,47,16,44,41,0,85,0,26,22,4,59
ODISHA,TOTAL CRIMES ,4971,11988,1,1,569,10628,229,10857,5531,40646,10628,0,51274,0,5698,653,5045,45576
PUNJAB,TOTAL CRIMES ,1782,3238,0,0,413,1842,288,2130,2477,6280,1842,0,8122,3,1330,388,942,6789
RAJASTHAN,TOTAL CRIMES ,1081,21106,0,2,9305,11388,174,11562,1318,47082,11388,0,58470,1738,7197,2761,4436,49535
SIKKIM,TOTAL CRIMES ,34,68,0,0,0,51,21,72,30,144,51,0,195,0,26,11,15,169
TAMIL NADU,TOTAL CRIMES ,4213,7192,0,0,844,4967,721,5688,4873,13073,4967,0,18040,2,3671,1060,2611,14367
TRIPURA,TOTAL CRIMES ,231,1559,0,0,7,1415,108,1523,260,4495,1415,558,5352,150,1839,279,1560,3363
UTTAR PRADESH,TOTAL CRIMES ,2851,23569,0,0,1296,15262,4685,19947,5177,44406,15262,0,59668,736,10953,5757,5196,47979
UTTARAKHAND,TOTAL CRIMES ,160,1067,0,0,58,794,194,988,181,3209,794,0,4003,56,867,607,260,3080
WEST BENGAL,TOTAL CRIMES ,22180,30942,0,6,163,30627,1858,32485,20468,132208,30627,0,162835,109,7737,607,7130,154989
TOTAL (STATES),TOTAL CRIMES ,91299,237931,5,415,22596,190642,16444,207086,99128,722330,190642,639,912333,15316,112143,23423,88720,784874
A & N ISLANDS,TOTAL CRIMES ,43,49,0,0,0,42,5,47,45,450,42,0,492,0,21,5,16,471
CHANDIGARH,TOTAL CRIMES ,140,241,0,0,18,190,15,205,158,466,190,0,656,0,127,23,104,529
D & N HAVELI,TOTAL CRIMES ,28,16,1,0,0,20,8,28,15,101,20,0,121,0,19,3,16,102
DAMAN & DIU,TOTAL CRIMES ,17,11,0,0,0,14,0,14,14,38,14,0,52,4,9,1,8,39
DELHI,TOTAL CRIMES ,8263,5959,99,24,808,3061,1169,4230,9061,12479,3061,0,15540,0,3047,1176,1871,12493
LAKSHADWEEP,TOTAL CRIMES ,0,2,0,0,0,0,0,0,2,4,0,0,4,3,1,0,1,0
PUDUCHERRY,TOTAL CRIMES ,39,61,0,2,4,52,1,53,41,517,52,0,569,0,57,9,48,512
TOTAL (UTs),TOTAL CRIMES ,8530,6339,100,26,830,3379,1198,4577,9336,14055,3379,0,17434,7,3281,1217,2064,14146
TOTAL (ALL-INDIA),TOTAL CRIMES ,99829,244270,105,441,23426,194021,17642,211663,108464,736385,194021,639,929767,15323,115424,24640,90784,799020
